[Map(startingDirection=UP)]
##########
##########
###      #
##  #    #
#   ##   #
#    #$$$#
##      ##
###    ###
##########
##########

[Buffs]
Oil: 66 51 27 47

[Agents(roundTime=10)]
Robot: 41
Vacuum: 46 27

