[Map(startingDirection=UP)]
####################################################################################################
####################################################################################################
####################################################################################################
######################################################          ###########        #################
#####################################################            #########          ################
###################################################               #######            ###############
##################################################                ######                ############
###################              ################                  ####                  ###########
#################                   ############                    ##                    ##########
###############                      ##########                     #                     ##########
##############                        #########                                            #########
#############                          #######            #                                 ########
############                           #######           ###                  ##              ######
###########                             ######         #####                 ###              ######
##########                              ######         ######               #####             ######
##########            #######           ######        ########              ######            ######
#########            ##########          #####        #########            ########           ######
########           #############          ####        ##########          ##########          ######
#######           ##############          ####        ############       ############         ######
#######           ##############          ####         ##############################         ######
######           ################          ###         ##############################         ######
######          ##################         ###              #########################         ######
######         ###################         ###                    ###################         ######
#####          ###################         ####                         #############         ######
#####         #####################        ####                           ###########         ######
#####         #####################        #####                           ##########$$$$$$$$$######
#####         #####################         #####                           #########         ######
#####        ######################         ######                          #########         ######
#####         #####################         ########                         ########         ######
#####         ######        #######          ###########                     ########         ######
#####         #####          #######           ###############               ########         ######
#####         ####            ######             ###################         ########          #####
######        ####             #####               ##################        ########           ####
######         ###              #####                 ##############         ########           ####
######         ###               #####                                       #########           ###
######         ##                 #####                                      ##########           ##
######         ##                  #####                                     ###########          ##
#######                            ######                                    ###########          ##
#######                            ########                                 #############         ##
#######                  #         ##########                              ###############        ##
#######                  ##        ############                           ####        ##          ##
########                ###        ###############                      ####                      ##
########               ###         ######################        ##########                       ##
#########             ###          #######################################                        ##
##########          ####           #############     ####################                        ###
###########        ####            #########           ##################                        ###
#####################             ########              #################                       ####
#################                ########                ################                      #####
################                ########                  ###############                   ########
##############                 ########                    ##############         ##       #########
##########                    ########                      #############          #################
#########                    ########                        ############          #################
########                    ########                         #############         #################
########                   #########           ####           ############         #################
#######                  ##########           ######          ###########          #################
#######              #############           ########          #########           #################
#######             #############           #########           #######            #################
#######             ###########             ##########                            ##################
#######                                    ###########                           ###################
#######                                   #############                         ####################
#######                                   ##############                       #####################
########                                 ################                     ######################
#########                               ##################                   #######################
##########                             ####################                #########################
############                         #######################              ##########################
################                   #################################################################
####################################################################################################
####################################################################################################
####################################################################################################
####################################################################################################
####################################################################################################
####################################################################################################
####################################################################################################
####################################################################################################
####################################################################################################
####################################################################################################
####################################################################################################
####################################################################################################
####################################################################################################
####################################################################################################
####################################################################################################
####################################################################################################
####################################################################################################
####################################################################################################
####################################################################################################
####################################################################################################
####################################################################################################
####################################################################################################
####################################################################################################
####################################################################################################
####################################################################################################
####################################################################################################
####################################################################################################
####################################################################################################
####################################################################################################
####################################################################################################
####################################################################################################
####################################################################################################
####################################################################################################
####################################################################################################

[Buffs(oilTimeout=300000)]
Oil: 457 677 955 963 984 987 1031 1120 1172 1175 1216 1226 1350 1363 1383 1588 1638 1668 1913 1991 2109 2188 2340 2440 2455 2461 2808 2838 3122 3147 3148 3246 3247 3248 3249 3250 3325 3345 3346 3347 3348 3349 3350 3351 3352 3353 3374 3408 3425 3445 3446 3447 3448 3449 3450 3451 3452 3453 3454 3511 3545 3546 3547 3548 3549 3550 3551 3552 3553 3554 3620 3646 3647 3648 3649 3650 3651 3652 3653 3654 3664 3692 3731 3746 3747 3748 3749 3750 3751 3752 3753 3754 3846 3847 3848 3849 3850 3851 3852 3853 3854 3859 3946 3947 3948 3949 3950 3951 3952 3953 3954 4047 4048 4049 4050 4051 4052 4053 4067 4129 4150 4151 4152 4192 4213 4281 4318 4385 4386 4689 4726 4730 4747 4748 4777 4820 4953 5045 5177 5215 5239 5242 5320 5359 5409 5455 5456 5476 5480 5516 5538 5580 5641 5712 5764 5765 5766 5767 5768 5769 5810 5821 5822 5823 5824 5825 5826 5827 5828 5829 5830 5863 5864 5865 5866 5867 5868 5869 5870 5920 5921 5922 5923 5924 5925 5926 5927 5928 5929 5930 5931 5932 5937 5963 5964 5965 5966 5967 5968 5969 5970 6020 6021 6022 6023 6024 6025 6026 6027 6028 6029 6030 6031 6060 6063 6064 6065 6066 6067 6068 6069 6070 6074 6114 6120 6121 6122 6123 6124 6125 6126 6127 6128 6129 6130 6131 6163 6164 6165 6166 6167 6168 6169 6170 6220 6221 6222 6223 6224 6225 6226 6227 6228 6229 6230 6263 6264 6265 6266 6267 6268 6269 6270 6321 6322 6323 6324 6325 6326 6327 6328 6329 6330 6336 6363 6364 6365 6366 6367 6368 6369 6370 6421 6422 6423 6424 6425 6426 6427 6428 6429 6464 6465 6466 6467 6468 6469 6522 6523 6524 6525 6526 6527 6528
Sticky: 561 658 727 852 972 983 1019 1020 1049 1064 1117 1123 1130 1164 1186 1230 1231 1235 1251 1268 1413 1414 1471 1472 1513 1518 1615 1649 1665 1687 1733 1752 1787 1811 1837 1840 1911 1989 1990 2052 2090 2192 2238 2258 2292 2348 2355 2452 2465 2511 2537 2607 2608 2640 2658 2669 2670 2756 2763 2771 2860 2867 2888 2940 2969 2987 3007 3025 3072 3125 3126 3139 3143 3175 3191 3220 3244 3294 3311 3328 3389 3390 3440 3461 3462 3471 3491 3522 3542 3561 3562 3567 3591 3593 3661 3662 3709 3756 3761 3762 3817 3820 3823 3824 3829 3861 3862 3867 3868 3872 3873 3892 3895 3912 3915 3917 3961 3962 4061 4062 4133 4134 4156 4161 4162 4221 4261 4262 4279 4282 4290 4292 4310 4379 4392 4416 4431 4475 4483 4494 4527 4585 4652 4679 4723 4728 4742 4746 4752 4785 4828 4882 4917 4975 4980 5021 5022 5111 5144 5148 5152 5157 5211 5212 5225 5418 5437 5541 5556 5660 5676 5775 5778 5814 5835 5857 5873 6017 6037 6038 6111 6117 6118 6173 6234 6259 6260 6415 6519

[Agents(roundTime=15)]
Robot: 2587 2588 2589 2590
Vacuum:

