[Map(startingDirection=UP)]
##################################################
#############################                 ####
###########        #########                   ###
########             ######                     ##
######                ####                      ##
#####                 ####     ############     ##
#####        ####     ####     ###########      ##
####      ########    ####      ########        ##
###      #########    ####        #####        ###
###     ##########    #####        ####      #####
##     ###########    #######       ###    #######
##     ###########    #########     ###    #######
##    ###    #####    ##########    ###        ###
##    ##      ####    ##########    ###         ##
##    #        ###                  ####        ##
##    #         ##                  #####        #
##               ##                #########     #
##        ##     ###              ##########    ##
###       ###    ###########################    ##
###      ####    ###########################$$$$##
####    #####    ###########################    ##
#############    #####           ##########     ##
#############    ####             #########     ##
#############    ###              #########     ##
#############    ###              ##   ####     ##
######           ###     #####    #     ###     ##
####             ###     #####           ##    ###
###             #####     ####           ##     ##
###            ######      ####          ##     ##
##     ###############      ###          ###    ##
##     ################      ###    #     ##    ##
#     #####         ####     ########     ##    ##
#     ####            ###     ########    ##    ##
#    #####             ##     ########    ##    ##
#    #####              ##     #######     #    ##
#   ######    #####     ##      ######     #    ##
#    #####     #####    ###      ######    #    ##
#    #####     #####    ####      #####         ##
#     #####    #####    #####      ####         ##
#              #####    ######      ####        ##
##             #####    #######     #####       ##
###           ######    #######     #####       ##
####         ######     #######     ######     ###
##################      #######    ###############
##################       #####     ###############
##################                 ###############
##################                ################
###################              #################
#######################         ##################
##################################################

[Buffs]
Oil: 83 84 85 86 87 88 89 90 91 132 133 134 135 136 137 138 139 140 141 142 144 182 183 184 185 186 187 188 189 190 191 192 194 214 233 234 235 236 237 238 239 240 241 269 278 306 346 391 482 570 591 654 661 695 708 720 734 742 764 826 954 1094 1095 1096 1115 1132 1143 1144 1145 1146 1147 1172 1178 1179 1193 1194 1195 1196 1197 1243 1244 1245 1246 1247 1294 1295 1296 1311 1322 1335 1364 1475 1482 1488 1495 1496 1503 1544 1545 1546 1547 1594 1595 1596 1597 1616 1619 1627 1641 1644 1645 1646 1647 1662 1669 1694 1695 1696 1697 1702 1745 1746 1790 1791 1796 1852 1880 1882 1945 1963 2043 2057 2058 2072 2133 2219 2221 2222 2232 2269 2282 2327 2374 2379 2429
Sticky: 114 117 129 208 209 211 216 217 245 246 258 308 311 344 357 371 406 407 430 443 454 456 470 491 493 554 569 590 619 640 694 713 722 746 752 753 754 760 761 769 774 802 808 812 819 823 824 828 831 846 855 864 872 873 895 905 907 914 915 957 1014 1066 1076 1077 1126 1164 1175 1214 1281 1307 1315 1356 1357 1359 1386 1387 1388 1405 1409 1410 1411 1432 1455 1554 1601 1602 1615 1664 1711 1716 1721 1771 1812 1863 1872 1903 1913 1971 2005 2021 2053 2054 2060 2071 2324

[Agents(roundTime=15)]
Robot: 994 995 996 997
Vacuum:

