Map:
##########
##########
###      #
##       #
#   ##   #
#   ##$$$#
##      ##
###    ###
##########
##########

Buffs:
Oil: 23 33
Sticky: 51 52 53

Agents:
Robot: 56 57 58
Vacuum: 73 
