Map:
##########
#        #
#        #
#        #
#        #
#$$$$$$$ #
#        #
#        #
#        #
##########

Agents(roundTime=30):
Robot: 32 35

Buffs:

